%%%%%%%%%%%%%%%%%%%%%%%%%
%.. P  ....             %
%..  ...  ...           %
%..  ...  ...           %
%..    ....           G %
%..  ...  ...           %
%                       %
%                       %
%%%%%%%%%%%%%%%%%%%%%%%%%
