%%%%%%%%%%%%%%%%%%%%%%%%%
%.. P  ....      ....   %
%..  ...  ...  ...  .   %
%..  ...  ...  ...      %
%..    ....      ...  G %
%..  ...  ...  ...      %
%..  ...  ...  ...  .   %
%..    ....      ....   %
%%%%%%%%%%%%%%%%%%%%%%%%%
